 1  2  2  2  2 20  2  3  1  2 20  3
 4  5  5 22  5  5  5  6  4  5  5  6
 4  5  5  5  5  5 22 12 13  5  5  6
14 23  5  5  5  5  5  5  5  5 24  6
 7  8  8  8 11  5  5  5  5  5 10  9
 1 17 18 19 13  5 24  5  5  5  6 21
14 24  5  5  5  5  5 22  5  5 15 21
 7  8  8  8  8  8  8  8  8  8  9 21