 1  2  2  2  2  2  2  3  1  2  2  3
 4  5  5  5  5  5  5  6  4  5  5  6
 4  5  5  5  5  5  5 12 13  5  5  6
 4  5  5  5  5  5  5  5  5  5  5  6
 7  8  8  8 11  5  5  5  5  5 10  9
 1 17 18 19 13  5  5  5  5  5  6 21
 4  5  5  5  5  5  5  5  5  5  6 21
 7  8  8  8  8  8  8  8  8  8  9 21